SO              ./texture/wall8.xpm
NO              ./texture/wall7.xpm
EA      ./texture/wall.xpm
C       102     ,178, 255
WE ./texture/wall6.xpm 
F			192,      192,192


111111111111111111111111111111111
1S0000000011000001110111111111111
11110111111111011100000010001
1111011111111101101010010001111
110000001101010111000000000001
1000000000000000000000000001111
1000000000000000001010000001
1100000111010101111100000000111
110000001101010111000000000001
1000000000000000000000000001111
1000000000000000001010000001
110000011101010111110000000111
110000001101010111000000000001
1000000000000000000000000001111111
1000000000000000010100000000000001
1100000111010101111100000000000001
1111111111111111111111111111111111
