
SO              ./texture/wall8.xpm
NO              ./texture/wall7.xpm
WE              ./texture/wall6.xpm
EA              ./texture/wall.xpm

C                       102,178,255
F			0,192,192

        1111111111111111111111111
        1000000000110000000000001
        1011000001110000000000001
        1001000000000000000000001
111111111011000001110000000000001
100000000011000001110111111111111
11110111111111011100000010001
1111011111111101  101010010001
110000001101010111000000000001
10000000000000000000000000001
10000000000000000001010000001
11000001110101011111000000E0111
11110111 1110101 101111010001
11111111 1111111 111111111111
