
NO	./path_to_the_north_texture

C			22,56,40
SO 			./path_to_the_south_texture
WE 			./path_to_the_west_texture
EA				./path_to_the_east_texture



F			25, 4 ,85

111111111111111111111111
1000000000110000000000001
1011000001  110000000000001
100		10000000  00000000000001
11111111101   1000001110000000000001
10000000001   1000001110111111111111
11110		111111111011100000010001
11110111111111011101010010001
110000001   10101N01110000010001
100000000000000011000000  10001
1000		000    000000001101010010001
110000011101010111110111100111
111101		1111101011  01111010001
1111111111  1111111111111111
