
NO ./path_to_the_north_texture


C 224,56,40
SO ./path_to_the_south_texture
WE 			./path_to_the_west_texture
EA				./path_to_the_east_texture

F			22,56,4

1111111111111111111111111
100000000011000000000001
11111011000001110000001
100001100000111011N0001111
11000001110101011111000111
1111011111101011011010001
11111111111111111111111111
