SO              ./texture/wall8.xpm
NO              ./texture/wall7.xpm 
F			192,      192,192
EA      ./texture/wall.xpm
C       102     ,178, 255
WE ./texture/wall6.xpm

111111111111111111111111111
        1111111111111111111111111
        100000000011000000000001
        1011000001110000000000001
        1001000000000000000000001
111111111011000001110000000000001
100000000011000001110111111111111
11110111111111011100000010001
1111011111111101101010010001111
110000001101010111000000000001
1000000000000000000000000001111
1000000000000000001010000001
1100000111010101111100000000111
110000001101010111000000000001
1000000000000000000000000001111
1000000000000000001010000001
1100000111010101111100000000111
110000001101010111000000000001
1000000000000000000000000001111
1000000000N00000001010000001
1100000111010101111100000000111
111111111111111111111111111111111
111111111111    111111111111111
