
NO ./path_to_the_north_texture


C 224,56,40
SO ./path_to_the_south_texture
WE 			./path_to_the_west_texture
EA				./path_to_the_east_texture

F			22,56,4

1111111111111111111111111
1000000000110000000000001
1111101100000111000000001
10000110000011101100001111
110000011101010111110N0111
1111011111101011011010001
11111111111111111111111111
