
NO ./path_to_the_north_texture


C 224,56,40
SO ./path_to_the_south_texture
WE 			./path_to_the_west_texture
EA				./path_to_the_east_texture

F			22,56,4

1111111111111111111111111
100000000011000000000000110111
101100000111000000000000101001
10010000000000000000000000100011
1111111110110000011100000N0000101
100000000011000001110111100111111
11110111111111011100000010001
11110111111111011101010010001
11000000110101011100000011111100001
10000000000000001100000010001
10000000000000001101010010001
1100000111010101111101111000111
11110111 1110101 101111010001
1111111111111111 111111111000011
                110000001
                   1111111
