
NO ./path_to_the_north_texture


C 224,56,40
SO ./path_to_the_south_texture
WE 			./path_to_the_west_texture
EA				./path_to_the_east_texture

F			22,56,4

11111111111111111111111111111
10010000000000000000000000100011
111111111011000000000010101111
11111111111111111N1111111100011
                110000001
                   1111111
