
NO ./path_to_the_north_texture


C 224,56,40
SO ./path_to_the_south_texture
WE 			./path_to_the_west_texture
EA				./path_to_the_east_texture

F			22,56,4

1111111111111111
1000000000000001
10000N0000000001
1000000000000011
1000011110000001
1111111111111111
