SO              ./texture/wall8.xpm
NO              ./texture/wall7.xpm
EA      ./texture/wall.xpm
WE ./texture/wall6.xpm 

C       102     ,178, 255
F			192,      192,192

111111111111111111111111111111111
10000000000000000000000000000000N1
111101111111110111000000100011111
1111011111111101101010010001111
110000001101010111000000000001
1000000000000000000000000001111
1000000000000000001010000001
1100000111010101111100000000111
110000001101010111000000000001
1000000000000000000000000001111
1000000000000000001010000001
10000001110101011111000000011
101111111111000000000111111111111111
1011111111000011111111111111111
100000001101010111000000000001
1000000000000000000000000001111111
10000000000000000000000000000000001
10000000000000000000000000000000001
1111111111111111111111111111111111
